4 9 2 2 3
4 6 2 2 3
4 4 4 4 4
4 9 2 2 3
4 6 2 2 3
4 4 4 4 4
