3 7 1 2 2
3 4 2 2 3
3 5 2 2 3
3 4 1 2 2
3 7 1 2 2
3 7 1 2 2
3 4 2 2 3
3 5 2 2 3
3 4 1 2 2
3 7 1 2 2
