4 9 1 2 4
4 9 1 2 2
4 7 1 2 2
4 30 2 2 4
4 8 2 2 3
4 9 1 2 4
4 9 1 2 2
4 7 1 2 2
4 30 2 2 4
4 8 2 2 3
