3 5 2 3 3
3 6 1 3 3
3 5 2 3 3
3 5 2 3 3
3 4 1 3 3
3 4 1 3 3
3 5 2 3 3
3 6 1 3 3
3 5 2 3 3
3 5 2 3 3
3 4 1 3 3
3 4 1 3 3
