3 7 1 1 2 1
3 4 1 1 2 1
3 5 1 1 2 1
3 4 1 1 2 1
3 9 1 1 2 1
