4 5 2 2 4 1
4 6 1 2 3 1
4 5 2 2 4 1
4 5 2 2 4 1
4 4 4 4 4 1
4 4 4 4 4 1
